##########
# # # # ##
         #
######## #
#        #
# ## ### #
# #    # #
# #  # #  
#    #   #
##########

Thief,5,4
Door,0,2,room2,9,7
Door,9,7,room5,0,1,KEY4
Key,2,2,KEY4