##########
         #
######## #
#        #
#        #
# ########
#        #
#        #
#        #
##########

Bat,7,8
Bat,8,7
Scorpio,8,1
HealingPotion,8,3
Door,0,1,room4,9,7
Treasure,8,8